!-----------------------------------------------------------------!----------!!----------!-|-------------------------------------------------------------.-!
.                                                                                                                                                          .
.                                                                                                                                                          .
.                                                                                                                                                          .
.                                                                                                                                                          .
.                                                                                                                                                          .
.                                                                                                                                                          .
.                                                                                                                                                          .
.                        +--------------------------------------------------------------------------------------------------------+                        .
.                        |\                                                                                                      /|                        .
.                        | \                                                                                                    / |                        .
.                        |  \                                                                                                  /  |                        .
.                        |   +------------------------------------------------------------------------------------------------+   |                        .
.                        |   |                                                                                                |   |                        .
.                        |   |                                                                                                |   |                        .
.                        |   |                                                                                                |   |                        .
.                        |   |                                                                                                |   |                        .
.                        |   |                                                                                                |   |                        .
!                        |   |                                                                                                |   |                        !
.                        |   |                                                                                                |   |                        .
.                        |   |                                                                                                |   |                        .
.                        |   |                                                                                                |   |                        .
!                        |   |                                                                                                |   |                        !
.                        |   |                                                                                                |   |                        !
.                        |   |                                                                                                |   |                        .
.                        |   |                                                                                                |   |                        .
.                        |   |                                                                                                |   |                        .
!                        |   |                                                                                                |   |                        !
.                        |   |                                                                                                |   |                        .
.                        |   |                                                                                                |   |                        .
.                        |   |                                                                                                |   |                        .
.                        |   |                                                                                                |   |                        .
.                        |   |                                                                                                |   |                        .
.                        |   +-----------------------------------------.            .-----------------------------------------+   |                        .
.                        |  /                                         /|            |\                                         \  |                        .
.                        | /                                         / |            | \                                         \ |                        .
.                        |/                                         /  |            |  \                                         \|                        .
.                        +-----------------------------------------/   |            |   \-----------------------------------------+                        .
.                                                                 |    |            |    |                                                                 .
.                                                                 |    |            |    |                                                                 .
.                                                                 |    |            |    |                                                                 .
.                                                                 |    |            |    |                                                                 .
.                                                                 |    |            |    |                                                                 .
.                                                                 |    |            |    |                                                                 .
!-----------------------------------------------------------------!----------!!----------!-----------------------------------------------------------------!
