!-----------------------------------------------------------------!----------!!----------!-|-------------------------------------------------------------.-!
.                                                                                                                                                          .
.                                                                                                                                                          .
.                                                                                                                                                          .
.                                                                                                                                                          .
.                                                                                                                                                          .
.                                                                                                                                                          .
.                                                                                                                                                          .
.                        +--------------------------------------------------------------------------------------------------------+                        .
.                        |\                                                                                                      /|                        .
.                        | \                                                                                                    / |                        .
.                        |  \                                                                                                  /  |                        .
.                        |   +------------------------------------------------------------------------------------------------+   |                        .
.                        |   |                                                                                                |   |                        .
.                        |   |                                                                                                |   |                        .
.                        |   |                                                                                                |   |                        .
.                        |   |                                                                                                |   |                        .
.                        |   |                                                                                                |   |                        .
!------------------------|   |                                                                                                |   |                        !
.                         \_ |                                                                                                |   |                        .
.___________________________\|                                                                                                |   |                        .
.                                                                                                                             |   |                        .
!                                                                                                                             |   |                        !
.                                                                                                                             |   |                        !
.____________________________                                                                                                 |   |                        .
.                          _/|                                                                                                |   |                        .
.                         /  |                                                                                                |   |                        .
!------------------------|   |                                                                                                |   |                        !
.                        |   |                                                                                                |   |                        .
.                        |   |                                                                                                |   |                        .
.                        |   |                                                                                                |   |                        .
.                        |   |                                                                                                |   |                        .
.                        |   |                                                                                                |   |                        .
.                        |   +------------------------------------------------------------------------------------------------+   |                        .
.                        |  /                                                                                                  \  |                        .
.                        | /                                                                                                    \ |                        .
.                        |/                                                                                                      \|                        .
.                        +--------------------------------------------------------------------------------------------------------+                        .
.                                                                                                                                                          .
.                                                                                                                                                          .
.                                                                                                                                                          .
.                                                                                                                                                          .
.                                                                                                                                                          .
.                                                                                                                                                          .
!-----------------------------------------------------------------!----------!!----------!-----------------------------------------------------------------!
