!-----------------------------------------------------------------!----------!!----------!-|-------------------------------------------------------------.-!
.                                                                                                                                                          .
.                                                                                                                                                          .
.                                                                                                                                                          .
.                                                                                                                                                          .
.                                                                                                                                                          .
.                                                                                                                                                          .
.                                                                                                                                                          .
.                        +--------------------------------------------------------------------------------------------------------+                        .
.                        |\                                                                                                      /|                        .
.                        | \                                                                                                    / |                        .
.                        |  \                                                                                                  /  |                        .
.                        |   +------------------------------------------------------------------------------------------------+   |                        .
.                        |   |                                                                                                |   |                        .
.                        |   |                                                                                                |   |                        .
.                        |   |                                                                                                |   |                        .
.                        |   |                                                                                                |   |                        .
.                        |   |                                                                                                |   |                        .
!                        |   |                                                                                                |   |------------------------!
.                        |   |                                                                                                | _/                         .
.                        |   |                                                                                                |/___________________________.
.                        |   |                                                                                                                             .
!                        |   |                                                                                                                             !
.                        |   |                                                                                                                             !
.                        |   |                                                                                                  ___________________________.
.                        |   |                                                                                                |\_                          .
.                        |   |                                                                                                |  \                         .
!                        |   |                                                                                                |   |------------------------!
.                        |   |                                                                                                |   |                        .
.                        |   |                                                                                                |   |                        .
.                        |   |                                                                                                |   |                        .
.                        |   |                                                                                                |   |                        .
.                        |   |                                                                                                |   |                        .
.                        |   +------------------------------------------------------------------------------------------------+   |                        .
.                        |  /                                                                                                  \  |                        .
.                        | /                                                                                                    \ |                        .
.                        |/                                                                                                      \|                        .
.                        +--------------------------------------------------------------------------------------------------------+                        .
.                                                                                                                                                          .
.                                                                                                                                                          .
.                                                                                                                                                          .
.                                                                                                                                                          .
.                                                                                                                                                          .
.                                                                                                                                                          .
!-----------------------------------------------------------------!----------!!----------!-----------------------------------------------------------------!
