!-----------------------------------------------------------------!----------!!----------!-|-------------------------------------------------------------.-!
.                                                                 |    |            |    |                                                                 .
.                                                                 |    |            |    |                                                                 .
.                                                                 |    |            |    |                                                                 .
.                                                                 |    |            |    |                                                                 .
.                                                                 |    |            |    |                                                                 .
.                                                                 |    |            |    |                                                                 .
.                                                                 |    |            |    |                                                                 .
.                        +---------------------------------------- \   |            |   /-----------------------------------------+                        .
.                        |\                                         \  |            |  /                                         /|                        .
.                        | \                                         \ |            | /                                         / |                        .
.                        |  \                                         \|            |/                                         /  |                        .
.                        |   +-----------------------------------------'            '-----------------------------------------+   |                        .
.                        |   |                                                                                                |   |                        .
.                        |   |                                                                                                |   |                        .
.                        |   |                                                                                                |   |                        .
.                        |   |                                                                                                |   |                        .
.                        |   |                                                                                                |   |                        .
!                        |   |                                                                                                |   |                        !
.                        |   |                                                                                                |   |                        .
.                        |   |                                                                                                |   |                        .
.                        |   |                                                                                                |   |                        .
!                        |   |                                                                                                |   |                        !
.                        |   |                                                                                                |   |                        !
.                        |   |                                                                                                |   |                        .
.                        |   |                                                                                                |   |                        .
.                        |   |                                                                                                |   |                        .
!                        |   |                                                                                                |   |                        !
.                        |   |                                                                                                |   |                        .
.                        |   |                                                                                                |   |                        .
.                        |   |                                                                                                |   |                        .
.                        |   |                                                                                                |   |                        .
.                        |   |                                                                                                |   |                        .
.                        |   +------------------------------------------------------------------------------------------------+   |                        .
.                        |  /                                                                                                  \  |                        .
.                        | /                                                                                                    \ |                        .
.                        |/                                                                                                      \|                        .
.                        +--------------------------------------------------------------------------------------------------------+                        .
.                                                                                                                                                          .
.                                                                                                                                                          .
.                                                                                                                                                          .
.                                                                                                                                                          .
.                                                                                                                                                          .
.                                                                                                                                                          .
!-----------------------------------------------------------------!----------!!----------!-----------------------------------------------------------------!
